# #############
#      ^      #
## ############
# ^           #
### ###########
#        ^    #
####### # #####
#     # #     #
#     ###     #
#   ^         #
########### ###
^             #
############ ##
#      ^      #
OOOOOOOOOOOOOOO
