# #############
#             #
##### #########
#             #
########### ###
#             #
###### ########
#             #
###### ########
#             #
###### #### ###
#    # #      #
#    ###      #
#             #
OOOOOOOOOOOOOOO
