# #############
#             #
#### # ########
#    # #      #
#    ###      #
#             #
###### ########
#             #
######### #####
#             #
###### ########
#             #
########### ###
#             #
OOOOOOOOOOOOOOO
