# #############
#             #
## ############
#             #
######## #### #
#           # ##
#           ####
#             #
######## # ####
#        # #  #
#        ###  #
#             #
########### ###
#             #
OOOOOOOOOOOOOOO
