# ##################################
#                                  #
##############################     #
#                                  #
#      #############################
#                                  #
#############################      #
#                                  #
#     ##############################
#                                  #
##########################         #
##########################OOOOOOOOO#