# ###########
#           #
####  #######
#       #   #
#  ######   #
#           O
###### ######
     # #
     ###