# ######
#      #
##### ##
#      #
###### #
#      #
###### #
OOOOOOOO
